%%%%%%%%%%%%%%%%%%%%%%%%%%%%%%%%%%%%%%%%%%%%%%%%%%%%%%%%%%%%%%%%%%%%%%%%%
%.                                 %%                                 .%%
% %%%%%%%%%%%%%%%%%%%%%%% %%%%%%%% %% %%%%%%%%%%%%%%%%%%%%%%% %%%%%%%% %%
% %%   %   %      %%%%%%%   %%     %% %%   %   %      %%%%%%%   %%     %%
% %% % % % % %%%% %%%%%%%%% %% %%%%%% %% % % % % %%%% %%%%%%%%% %% %%%%%%
% %% % % % %             %% %%     %% %% % % % %             %% %%     %%
% %% % % % % % %%%%  %%%    %%%%%% %% %% % % % % % %%%%  %%%    %%%%%% %%
% %  % % %   %    %% %%%%%%%%         %  % % %   %    %% %%%%%%%%      %%
% %% % % %%%%%%%% %%        %% %%%%%% %% % % %%%%%%%% %%        %% %%%%%%
% %% %   %%       %%%%%%%%% %%     %% %% %   %%       %%%%%%%%% %%     %%
%    %%%%%% %%%%%%%      %% %%%%%% %%    %%%%%% %%%%%%%      %% %%%%%% %%
%%%%%%      %       %%%% %% %    P %%%%%%%      %       %%%% %% %      %%
%      %%%%%% %%%%% %    %% %% %%%%%%      %%%%%% %%%%% %    %% %% %%%%%%
% %%%%%%      %       %%%%% %%     %% %%%%%%      %       %%%%% %%     %%
%        %%%%%% %%%%%%%%%%% %%  %% %%        %%%%%% %%%%%%%%%%% %%  %% %%
%%%%%%%%%%                  %%%%%% %%%%%%%%%%%                  %%%%%% %%
%          %%%%%%%%%%%%%%%%                    %%%%%%%%%%%%%%%%        %%
%%%%%%%% %%%%%%%%%%%%%%%%%%%%%%%%% %%%%%%%%%%%%%%%%%%%%%%%%%%%%%%% %%%%%%
%                                  %%                                  %%
% %%%%%%%%%%%%%%%%%%%%%%% %%%%%%%% %% %%%%%%%%%%%%%%%%%%%%%%% %%%%%%%% %%
% %%   %   %      %%%%%%%   %%     %% %%   %   %      %%%%%%%   %%     %%
% %% % % % % %%%% %%%%%%%%% %% %%%%%% %% % % % % %%%% %%%%%%%%% %% %%%%%%
% %% % % % %             %% %%        %% % % % %             %% %%     %%
% %% % % % % % %%%%  %%%    %%%%%% %% %% % % % % % %%%%  %%%    %%%%%% %%
% %  % % %   %    %% %%%%%%%%      %% %  % % %   %    %% %%%%%%%%      %%
% %% % % %%%%%%%% %%        %% %%%%%% %% % % %%%%%%%% %%        %% %%%%%%
% %% %   %%       %%%%%%%%% %%     %% %% %   %%       %%%%%%%%% %%     %%
%    %%%%%% %%%%%%%      %% %%%%%% %%    %%%%%% %%%%%%%      %% %%%%%% %%
%%%%%%      %       %%%% %% %      %%%%%%%      %       %%%% %% %      %%
%      %%%%%% %%%%% %    %% %% %%%%%%      %%%%%% %%%%% %    %% %% %%%%%%
% %%%%%%      %       %%%%% %%     %% %%%%%%      %       %%%%% %%     %%
%        %%%%%% %%%%%%%%%%% %%  %% %%        %%%%%% %%%%%%%%%%% %%  %% %%
%%%%%%%%%%                  %%%%%% %%%%%%%%%%%                  %%%%%% %%
%.         %%%%%%%%%%%%%%%%                    %%%%%%%%%%%%%%%%       .%%
%%%%%%%%%%%%%%%%%%%%%%%%%%%%%%%%%%%%%%%%%%%%%%%%%%%%%%%%%%%%%%%%%%%%%%%%%