%%%%%%%%%%%%%%%%%%%%%%%%%%%%%%%%%%%%%%%%%%%%%%%%%%%%%%%%%%%%%%%%%%%%%%%%%
%..................................%%.................................P%%
%.%%%%%%%%%%%%%%%%%%%%%%%.%%%%%%%%.%%.%%%%%%%%%%%%%%%%%%%%%%%.%%%%%%%%.%%
%.%%...%...%......%%%%%%%...%%.....%%.%%...%...%......%%%%%%%...%%.....%%
%.%%.%.%.%.%.%%%%.%%%%%%%%%.%%.%%%%%%.%%.%.%.%.%.%%%%.%%%%%%%%%.%%.%%%%%%
%.%%.%.%.%.%.............%%.%%.....%%.%%.%.%.%.%.............%%.%%.....%%
%.%%.%.%.%.%.%.%%%%..%%%....%%%%%%.%%.%%.%.%.%.%.%.%%%%..%%%....%%%%%%.%%
%.%..%.%.%...%....%%.%%%%%%%%.........%..%.%.%...%....%%.%%%%%%%%......%%
%.%%.%.%.%%%%%%%%.%%........%%.%%%%%%.%%.%.%.%%%%%%%%.%%........%%.%%%%%%
%.%%.%...%%.......%%%%%%%%%.%%.....%%.%%.%...%%.......%%%%%%%%%.%%.....%%
%....%%%%%%.%%%%%%%......%%.%%%%%%.%%....%%%%%%.%%%%%%%......%%.%%%%%%.%%
%%%%%%......%.......%%%%.%%.%......%%%%%%%......%.......%%%%.%%.%......%%
%......%%%%%%.%%%%%.%....%%.%%.%%%%%%......%%%%%%.%%%%%.%....%%.%%.%%%%%%
%.%%%%%%......%.......%%%%%.%%.....%%.%%%%%%......%.......%%%%%.%%.....%%
%........%%%%%%.%%%%%%%%%%%.%%..%%.%%........%%%%%%.%%%%%%%%%%%.%%..%%.%%
%%%%%%%%%%..................%%%%%%.%%%%%%%%%%%..................%%%%%%.%%
%..........%%%%%%%%%%%%%%%%....................%%%%%%%%%%%%%%%%........%%
%%%%%%%%.%%%%%%%%%%%%%%%%%%%%%%%%%.%%%%%%%%%%%%%%%%%%%%%%%%%%%%%%%.%%%%%%
%..................................%%..................................%%
%.%%%%%%%%%%%%%%%%%%%%%%%.%%%%%%%%.%%.%%%%%%%%%%%%%%%%%%%%%%%.%%%%%%%%.%%
%.%%...%...%......%%%%%%%...%%.....%%.%%...%...%......%%%%%%%...%%.....%%
%.%%.%.%.%.%.%%%%.%%%%%%%%%.%%.%%%%%%.%%.%.%.%.%.%%%%.%%%%%%%%%.%%.%%%%%%
%.%%.%.%.%.%.............%%.%%........%%.%.%.%.%.............%%.%%.....%%
%.%%.%.%.%.%.%.%%%%..%%%....%%%%%%.%%.%%.%.%.%.%.%.%%%%..%%%....%%%%%%.%%
%.%..%.%.%...%....%%.%%%%%%%%......%%.%..%.%.%...%....%%.%%%%%%%%......%%
%.%%.%.%.%%%%%%%%.%%........%%.%%%%%%.%%.%.%.%%%%%%%%.%%........%%.%%%%%%
%.%%.%...%%.......%%%%%%%%%.%%.....%%.%%.%...%%.......%%%%%%%%%.%%.....%%
%....%%%%%%.%%%%%%%......%%.%%%%%%.%%....%%%%%%.%%%%%%%......%%.%%%%%%.%%
%%%%%%......%.......%%%%.%%.%......%%%%%%%......%.......%%%%.%%.%......%%
%......%%%%%%.%%%%%.%....%%.%%.%%%%%%......%%%%%%.%%%%%.%....%%.%%.%%%%%%
%.%%%%%%......%.......%%%%%.%%.....%%.%%%%%%......%.......%%%%%.%%.....%%
%........%%%%%%.%%%%%%%%%%%.%%..%%.%%........%%%%%%.%%%%%%%%%%%.%%..%%.%%
%%%%%%%%%%..................%%%%%%.%%%%%%%%%%%..................%%%%%%.%%
%..........%%%%%%%%%%%%%%%%....................%%%%%%%%%%%%%%%%........%%
%%%%%%%%%%%%%%%%%%%%%%%%%%%%%%%%%%%%%%%%%%%%%%%%%%%%%%%%%%%%%%%%%%%%%%%%%