%%%%%%%%%%%%%%%%%%%%%%%%%%%%%%%%%%%%%%%%%%%%%%%%%%%%%%%%%%%%%%%%%%%%%%%%%%%%%%%%%%%%%%%%%%%%%%%%%%%%%%%%%%%%
%                                  %%                                  %%                                 P%
% %%%%%%%%%%%%%%%%%%%%%%% %%%%%%%% %% %%%%%%%%%%%%%%%%%%%%%%% %%%%%%%% %% %%%%%%%%%%%%%%%%%%%%%%% %%%%%%%% %
% %%   %   %      %%%%%%%   %%     %% %%   %   %      %%%%%%%   %%     %% %%   %   %      %%%%%%%   %%     %
% %% % % % % %%%% %%%%%%%%% %% %%%%%% %% % % % % %%%% %%%%%%%%% %% %%%%%% %% % % % % %%%% %%%%%%%%% %% %%%%%
% %% % % % %             %% %%     %% %% % % % %             %% %%     %% %% % % % %             %% %%     %
% %% % % % % % %%%%  %%%    %%%%%% %% %% % % % % % %%%%  %%%    %%%%%% %% %% % % % % % %%%%  %%%    %%%%%% %
% %  % % %   %    %% %%%%%%%%         %  % % %   %    %% %%%%%%%%      %% %  % % %   %    %% %%%%%%%%      %
% %% % % %%%%%%%% %%        %% %%%%%% %% % % %%%%%%%% %%        %% %%%%%% %% % % %%%%%%%% %%        %% %%%%%
% %% %   %%       %%%%%%%%% %%     %% %% %   %%       %%%%%%%%% %%     %% %% %   %%       %%%%%%%%% %%     %
%    %%%%%% %%%%%%%      %% %%%%%% %%    %%%%%% %%%%%%%      %% %%%%%% %%    %%%%%% %%%%%%%      %% %%%%%% %
%%%%%%      %       %%%% %% %      %%%%%%%      %       %%%% %% %      %%%%%%%      %       %%%% %% %      %
%      %%%%%% %%%%% %    %% %% %%%%%%      %%%%%% %%%%% %    %% %% %%%%%%      %%%%%% %%%%% %    %% %% %%%%%
% %%%%%%      %       %%%%% %%     %% %%%%%%      %       %%%%% %%     %% %%%%%%      %       %%%%% %%     %
%        %%%%%% %%%%%%%%%%% %%  %% %%        %%%%%% %%%%%%%%%%% %%  %%           %%%%%% %%%%%%%%%%% %%  %% %
%%%%%%%%%%                  %%%%%% %%%%%%%%%%%                  %%%%%% %%%%%%%%%%%                  %%%%%% %
%          %%%%%%%%%%%%%%%%                    %%%%%%%%%%%%%%%%        %%          %%%%%%%%%%%%%%%%        %
%%%%%%%% %%%%%%%%%%%%%%%%%%%%%%%%% %%%%%%%%%%%%%%%%%%%%%%%%%%%%%%% %%%%%%% %%%%%%%%%%%%%%%%%%%%%%%%%%%%%%%%%
%%%%%%%% %%%%%%%%%%%%%%%%%%%%%%%%% %%%%%%%%%%%%%%%%%%%%%%%%%%%%%%% %%%%%%% %%%%%%%%%%%%%%%%%%%%%%%%%%%%%%%%%
%                                  %%                                  %%                                  %
% %%%%%%%%%%%%%%%%%%%%%%% %%%%%%%% %% %%%%%%%%%%%%%%%%%%%%%%% %%%%%%%% %% %%%%%%%%%%%%%%%%%%%%%%% %%%%%%%% %
% %%   %   %      %%%%%%%   %%     %% %%   %   %      %%%%%%%   %%     %% %%   %   %      %%%%%%%   %%     %
% %% % % % % %%%% %%%%%%%%% %% %%%%%% %% % % % % %%%% %%%%%%%%% %% %%%%%% %% % % % % %%%% %%%%%%%%% %% %%%%%
% %% % % % %             %% %%        %% % % % %             %% %%     %% %% % % % %             %% %%     %
% %% % % % % % %%%%  %%%    %%%%%% %% %% % % % % % %%%%  %%%    %%%%%% %% %% % % % % % %%%%  %%%    %%%%%% %
% %  % % %   %    %% %%%%%%%%      %% %  % % %   %    %% %%%%%%%%      %% %  % % %   %    %% %%%%%%%%      %
% %% % % %%%%%%%% %%        %% %%%%%% %% % % %%%%%%%% %%        %% %%%%%% %% % % %%%%%%%% %%        %% %%%%%
% %% %   %%       %%%%%%%%% %%     %% %% %   %%       %%%%%%%%% %%        %% %   %%       %%%%%%%%% %%     %
%    %%%%%% %%%%%%%      %% %%%%%% %%    %%%%%% %%%%%%%      %% %%%%%% %%    %%%%%% %%%%%%%      %% %%%%%% %
%%%%%%      %       %%%% %% %      %%%%%%%      %       %%%% %% %      %%%%%%%      %       %%%% %% %      %
%      %%%%%% %%%%% %    %% %% %%%%%%      %%%%%% %%%%% %    %% %% %%%%%%      %%%%%% %%%%% %    %% %% %%%%%
% %%%%%%      %       %%%%% %%     %% %%%%%%      %       %%%%% %%     %% %%%%%%      %       %%%%% %%     %
%        %%%%%% %%%%%%%%%%% %%  %% %%        %%%%%% %%%%%%%%%%% %%  %% %%        %%%%%% %%%%%%%%%%% %%  %% %
%%%%%%%%%%                  %%%%%% %%%%%%%%%%%                  %%%%%% %%%%%%%%%%%                  %%%%%% %
%.         %%%%%%%%%%%%%%%%                    %%%%%%%%%%%%%%%%        %%          %%%%%%%%%%%%%%%%        %
%%%%%%%%%%%%%%%%%%%%%%%%%%%%%%%%%%%%%%%%%%%%%%%%%%%%%%%%%%%%%%%%%%%%%%%%%%%%%%%%%%%%%%%%%%%%%%%%%%%%%%%%%%%%