%%%%%%%%%%%%%%%%%%%%%%%%%%%%%%%%%%%%%%%%%%%%%%%%%%%%%%%%%%%%%%%%%%%%%%%%%
%            .....                .%%                                 P%%
%.%%%%%%%%%%%%%%%%%%%%%%%.%%%%%%%%.%%.%%%%%%%%%%%%%%%%%%%%%%%.%%%%%%%%.%%
%.%%   %   %      %%%%%%%   %%   ..%%.%%   %   %      %%%%%%%   %%   ..%%
%.%%.%.%.%.%.%%%%.%%%%%%%%%.%%.%%%%%%.%%.%.%.%.%.%%%%.%%%%%%%%%.%%.%%%%%%
%.%%.%.%.%.%            .%%.%%   ..%%.%%.%.%.%.%            .%%.%%   ..%%
%.%%.%.%.%.%.%.%%%%..%%%   .%%%%%%.%%.%%.%.%.%.%.%.%%%%..%%%   .%%%%%%.%%
%.%..%.%.%   %   .%%.%%%%%%%%         %..%.%.%   %   .%%.%%%%%%%%      %%
%.%%.%.%.%%%%%%%%.%%      ..%%.%%%%%%.%%.%.%.%%%%%%%%.%%      ..%%.%%%%%%
%.%%.%   %%      .%%%%%%%%%.%%   ..%%.%%.%   %%      .%%%%%%%%%.%%   ..%%
%   .%%%%%%.%%%%%%%      %%.%%%%%%.%%   .%%%%%%.%%%%%%%      %%.%%%%%%.%%
%%%%%%      %      .%%%%.%%.%      %%%%%%%      %      .%%%%.%%.%      %%
%  ..  %%%%%%.%%%%%.%   .%%.%%.%%%%%%      %%%%%%.%%%%%.%   .%%.%%.%%%%%%
%.%%%%%%      %      .%%%%%.%%   ..%%.%%%%%%      %      .%%%%%.%%   ..%%
%      ..%%%%%%.%%%%%%%%%%%.%%..%%.%%      ..%%%%%%.%%%%%%%%%%%.%%..%%.%%
%%%%%%%%%%     ........     %%%%%%.%%%%%%%%%%%                  %%%%%%.%%
%         .%%%%%%%%%%%%%%%%                  ..%%%%%%%%%%%%%%%%      ..%%
%%%%%%%%.%%%%%%%%%%%%%%%%%%%%%%%%%.%%%%%%%%%%%%%%%%%%%%%%%%%%%%%%%.%%%%%%
%                                 .%%.....               ...          .%%
%.%%%%%%%%%%%%%%%%%%%%%%%.%%%%%%%%.%%.%%%%%%%%%%%%%%%%%%%%%%%.%%%%%%%%.%%
%.%%   %   %      %%%%%%%   %%   ..%%.%%   %   %      %%%%%%%   %%   ..%%
%.%%.%.%.%.%.%%%%.%%%%%%%%%.%%.%%%%%%.%%.%.%.%.%.%%%%.%%%%%%%%%.%%.%%%%%%
%.%%.%.%.%.%            .%%.%%      ..%%.%.%.%.%            .%%.%%   ..%%
%.%%.%.%.%.%.%.%%%%..%%%   .%%%%%%.%%.%%.%.%.%.%.%.%%%%..%%%   .%%%%%%.%%
%.%..%.%.%   %   .%%.%%%%%%%%      %%.%..%.%.%   %   .%%.%%%%%%%%      %%
%.%%.%.%.%%%%%%%%.%%      ..%%.%%%%%%.%%.%.%.%%%%%%%%.%%      ..%%.%%%%%%
%.%%.%   %%      .%%%%%%%%%.%%   ..%%.%%.%   %%      .%%%%%%%%%.%%   ..%%
%   .%%%%%%.%%%%%%%      %%.%%%%%%.%%   .%%%%%%.%%%%%%%      %%.%%%%%%.%%
%%%%%%      %      .%%%%.%%.%      %%%%%%%      %      .%%%%.%%.%      %%
%      %%%%%%.%%%%%.%   .%%.%%.%%%%%%      %%%%%%.%%%%%.%   .%%.%%.%%%%%%
%.%%%%%%      %      .%%%%%.%%   ..%%.%%%%%%      %      .%%%%%.%%   ..%%
%      ..%%%%%%.%%%%%%%%%%%.%%..%%.%%      ..%%%%%%.%%%%%%%%%%%.%%..%%.%%
%%%%%%%%%%                  %%%%%%.%%%%%%%%%%%                  %%%%%%.%%
%         .%%%%%%%%%%%%%%%%                  ..%%%%%%%%%%%%%%%%      ..%%
%%%%%%%%%%%%%%%%%%%%%%%%%%%%%%%%%%%%%%%%%%%%%%%%%%%%%%%%%%%%%%%%%%%%%%%%%