%%%%%%%%%%%%%%%%%%%%%%%%%%%%%%%%%%%%%%%
%.           ..%   %.           ..%   %
%.%%.%%.%%.%%.%% % %.%%.%%.%%.%%.%% % %
%        P       %         ..         %
%%%%%%%%%%%%%%%%%% %%%%%%%%%%%%%%%%%% %
%.....              %          .......%
%%%%%%%%%%%%%%%%%%%%%%%%%%%%%%%%%%%%%%%